1111111
1P000E1
1111011
1C00011
1111111