1111111111111111111111111111111
111111111111111101
111111111011111
1PCE01111111
111111111111111111