11111111111
100P0000E11
10100C00001
11111111111