11111111111111111111111111
1P10000001C001000001000001
100001000000000010000010E1
10000000000000001000011001
10111111111000011100000001
11111111111111111111111111