111111111111111111
111000000P00000001
100000000000000001
111111000000000001
10C00E000000000001
111111000000000001
10000000000000C001
111111111111111111